R 640 580

NO ./north_texture1   
SO ./south_texture
WE ./west_texture
EA ./east_texture

S ./sprite_texture

F 120,100,0
C 1,1,1

11111111111111111
10000000000000001       111 111
10000000000000001      100010001
10000000000000001      100000001
10000000000000001       1000001
10000000000000001        10001
11000111000000001         101
100001 100000001           1
111111 1000N001
1111   1111111