R 1920 1080

NO ./textures/north.xpm   
SO ./textures/south.xpm
WE ./textures/west.xpm
EA ./textures/east.xpm

S ./textures/tonneau.xpm

F 120,100,0
C 1,1,1

11111111111111111
10001111100000001       111 111
10000000000000001      100010001
10000100100100001      100000001
10000000000000001       1000001
10000000000200001        10001
11000111000000001         101
100001 1000000031111111111131
100111 1000N00300000000000001
1001   1111111111111111111111
1001
1001
1001
1001
1001
1001
1001
1001
1001
1001
1001
1001
1001
1001
1001
1001
1001
1001
1111