R 1920 1080

NO ./textures/north.xpm   
SO ./textures/south.xpm
WE ./textures/west.xpm
EA ./textures/east.xpm

S ./textures/pikapika.xpm

F 120,100,0
C 1,1,1

11111111111111111
10001111100000001       111 111
10000000000000001      100010001
10000100100100001      100000001
10000000000000001       1000001
10000000000200001        10001
11000111000000001         101
100001 1000000031111111111131
100111 1000N00300000000000001
1001   1111111111111111111111
1001
1001
1001
1001
1001
1001
1001
1001
1001
100111111111111111111111111111111111111111111111111111111111111111111111111111111111111111111111111111111111111111111111111111
100000000001000000000000000000000000000000000000000000000000000000000000000000000000000000000000000000000000000000000000000001
100000000001000000000000000000000000000000000000000000000000000000000000000000000000000000000000000000000000000000000000000001
100000000000000000002000000000000000000000000000020000000000000000000000000000000000220000000000000000000000000002200000000001
100000000000100000000000000000000100000000000000000000000000000000000000000000000000000000000000000000000000000000000000000001
100000000000000000000000000000000000000000000002100000000000000000000000000020000000000000000111100000000000000000000000000001
100000000000000000000000000000000000010000000000000000000000000000000000000000000000000000000000000000000000000000000000000001
100000000000000000000000000000000000000000000000000000000000000000000000000000000000000000000000000000000000000000000000000001
100002000001000000000000000000000000000000000001000000000000000000000000000000000000000000000000000000000000000000000000000001
100000000000000000000000010000000000000000000000000002000000000000000000000000000000000000000000000000000000000000000220000001
100000000000100000000000000000000000000000000000000000000000000000000000000010000000000000000000000000000000000000000000011111
100000000000000000000000000000000000000000000000000000000000000000000000000000002000000000000000000000000000000000000000000001
100000000000000000000000000000000000000000000000000000000000000000000000000000000000000000000000000000000000000000000000000001
100000000000000000000001000000000000000000000000001100000000000000000000000000000000000000000001111000000000000000000000000001
100000000000000000000000000000010000000000000000000000000000000011000000000000000000000000000000000000000000000000000000000001
100000000000000000000000000000000000000000000000000000000000000010000000000000000000000000000000000000000000000000000000000001
100000000000000000000000000000000000000000000000100000000000000010000000000000000000000000000000000000000000000000000000000001
100000000000000000000000000000000000000000000000000000000000000110000000000000000100000000000000000000000000000000000000000001
100000000000000000011000000000000000000000100000000002000000000000000000000000000000000000000000000000000000000000000000000001
100000000000000000010000000000000000000000000000000000000000000000000000000000000100000000000000000000000000000000000000000001
100000000000000000010000000001000000000000000000000000000000000000000000000000000100000000000000000000000011100000000000000001
100000000000000000110000000000000000000000000000000000000000001100000000000000000100000000000000000000000010000000000000000001
100000000000000000000000000000000000000011000000100000000000001000000000000000000100000000000000000000000011000000000000000001
100000000000000000000000011000000000000010000000000000000000001000000000000000000000000000000000000000000001011100000000000001
100000000000000000000000010000000000000010000000000000000000011000000000000000000000000000000000000000111000010000000000000001
100000000000000000000000010000000000000110000000000000200000000000000000000000000000000000000000000000100000011000000000000001
100000000000000000000000110000000000000000000000000000000000000000000000000000000000000000000000000000110000001000000000000001
100002000000000000000000000200000000000000000000000000000000000000000000000010000000000000000000000000010000000000000000000001
100000000000000000000000000000000000000000000000000200000000000000000000000000000000000000000000000000000000000000000000000001
100000000000000000000000000000000000000000000000000000000000000000000000000000000000000000000000000000000000000000000000000001
100000000000000001100000000000000000000011000000001000000000000000000000000000000000020000000000000000000000000000200000000001
100000000020000001000000000000000000000210000000000020000000000000000010000000000220000000000000000000000000000200000000000001
100000000000000001000000000000000000000010000000000000000000000000000000000000000000000000000000000000000000000000000000000001
100000000000000011000000000000000000000110000000000000000100000000000010000000000000000000000000000000000000000000000000000001
100000000000000000000000000000000000000000000000000000000000000000000000000000000000000000000000000000000000000000000000000001
100000000000000000000000000000000000000000000000000000000000000000000000000000000000000000000000000000000000000000000000000001
100000000000000000000000000000000010000000000000000000000000000100000000000000000000000000000000000000000000000000000020000001
100000000000000000000000000000000000000000020000000000000000000000000000000000000000020000000000000000000000000000020000000001
100000000000000000000000000000000000000000000000000000000000000000000000000000010000000000000000000000000000000000000000000001
100000000000000000000000000000000000000000000000000000000000000000000010000000000000000000000000000000000000000000000000000001
100000000000000000000000000000000000000000000000000000000000000000000000000000000000000000000000000000000000000000000000000001
100000000001000000000000000000000000000000000000000000000000000100000000000000000000000000000000000000000000000000000000000001
100000000000000000000000000000000000000000000000000000000000000000000000000000000000000000000000000000000001000000000000000001
100000000000000000000000000000000000000000000000000000000000000000000000000000000010000000000000000000000000000000000000000001
100000000000000000000000000000000000000000000000000000000000000000000000000000000000000000000000000000000000000000000000000001
100000000000100000000000000000000000000000000000001000000000000000000000000000000000000000000000000000001110001000000000000001
100000000000000000000000000000000000000000000000000000000000000000000000000000000000010000000000000000010000000000000000000001
100000000000000000000000010000000000000000000000000000000000000000000000000000000000000000000000000000000000000000100000000001
100000000000000000000000000000000000000000000000000000000000000000000000000100000000000000000000000000000000000000000000000001
100000000000000000000000000000000000000000000000000000000000000000000000000000000000000000000000000000000000000000000000000001
100000000000000000000000000000000000000000000000000000000000000000000000000000000000000000000000000000000000000000000000000001
111111111111111111111111111111111111111111111111111111111111111111111111111111111111111111111111111111111111111111111111111111