R 1920 1080

NO ./textures/white_grunge.xpm
SO ./textures/brick.xpm
WE ./textures/metal_plate.xpm
EA ./textures/wood.xpm

S ./textures/tonneau.xpm

F 100,100,0
C 1,1,1

11111111111111111
10001111100000001       111 111
10000000000000001      100010001
10000100100100001      100000001
10000000000000001       1000001
1000000000E200001        10001
11000111000000001         101
100001 1000000031111111111131
100111 1000000300000000000001
1001   1111111111111111111111
1001
1001
1001
1001
1001
1001
1001
1001
1001
100111111111111111111111111111111111111111111111111111111111111111111111111111111111111111111111111111111111111111111111111111
100000000001000000000000000000000000000000000000000000000000000000000000000000000000000000000000000000000000000000000000000001
100000000001000000000000000000000000000000000000000000000000000000000000000000000000000000000000000000000000000000000000000001
102000000000000000020000000000000000000000000000000000000000000000000000000000000000000000000000000000000000000000000000000001
102000000000100000000000000000000100000000000000000000000002000000000000000000000000000000000000000000000000000000000000000001
102000000000000000000000000000000000000000000000100000000000000000000000000000000000000000000111100000000000000000000000000001
102000000000000000000000000000000000010000000000000000000000000000000000000000000000000000000000000000000000000000000000000001
102000000000000000000000000000000000000000000000000000000000000000000000000000000000000000000000000000000000000000000000000001
102000000001000000000000000000000000000000000001000000000000000000000000000000000000000000000000000000000000000000000000000001
102200000000000000000000010000000000000000000000000000000000000000000000000000000000000000000000000000000000000000000000000001
100000000000100000000000000000000000000000000000000000000000000000000000000010000000000000000000000000000000000000000000011111
102002000000000000000000000000020000000000000000000000000000000000000000000000000000000000000000000000000000000000000000000001
100002002000000000000000000000000000000000000000000000000000000000000000000000000000000000000000000000000000000000000000000001
100000000000000000000001000000000000000000000000001100000000000000000000000000000000000000000001111000000000000000000000000001
100000002000200000000000000000010000000000000000000000000000000011000000000000000000000000000000000000000000000000000000000001
100000000000000000000000000000000000000000000000000000000000000010000000000000000000000000000000000000000000000000000000000001
100000000000000000000000000000000000000000000000100000000000000010000000000000000000000000000000000000000000000000000000000001
100000000000000000000000000000000000000000000000000000000000000110000000000000000100000000000000000000000000000000000000000001
100000000000000000011000000000000000000000100000000000000000000000000000000000000000000000000000000000000000000000000000000001
100000000000000000010000000000000000000000000000000000000000000000000000000000000100000000000000000000000000000000000000000001
100000000000000000010000000001000000000000002000000000000000000000000000000000000100000000000000000000000011100000000000000001
100000000000000000110000000000000000000000000000000000000000001100000000000000000100000000000000000000000010000000000000000001
100000000000000000000000000000000000000011000000100000000002001000000000000000000100000000000000000000000011000000000000000001
100000000000000000000000011000000000000010000000000000000000001000000000000000000000000000000000000000000001011100000000000001
100000000000000000000000010000000000000010000000000000000000011000000000000000000000000000000000000000111000010000000000000001
100000000000000000000000010000000000000110000000000000000000000000000000000000000000000000000000000000100000011000000000000001
100000000000000000000000110000000000000000000000000000000000000000000000000000000000000000000000000000110000001000000000000001
100000000000000000000000000000000000000000000000000000000000000000000000000010000000000000000000000000010000000000000000000001
100000000000000000000000000000000000000000000000000000000000000000000000000000000000000000000000000000000000000000000000000001
100000000000000000000000000000000000000000000000000000000000000000000000000000000000000000000000000000000000000000000000000001
100000000000000001100000000000000000000011000000001000000000000000000000000000000000000000000000000000000000000000000000000001
100000000000000001000000000000000000000010000000000000000000000000000010000000000000000000000000000000000000000000000000000001
100000000000000001000000000000000000000010000000000000000000000000000000000000000000000000000000000000000000000000000000000001
100000000000000011000000000000000000000110000000000000000100000000000010000000000000000000000000000000000000000000000000000001
100000000000000000000000000000000000000000000000000000000000000000000000000000000000000000000000000000000000000000000000000001
100000000000000000000000000000000000000000000000000000000000000000000000000000000000000000000000000000000000000000000000000001
100000000000000000000000000000000010000000000000000000000000000100000000000000000000000000000000000000000000000000000000000001
100000000000000000000000000000000000000000000000000000000000000000000000000000000000000000000000000000000000000000000000000001
100000000000000000000000000000000000000000000000000000000000000000000000000000010000000000000000000000000000000000000000000001
100000000000000000000000000000000000000000000000000000000000000000000010000000000000000000000000000000000000000000000000000001
100000000000000000000000000000000000000000000000000000000000000000000000000000000000000000000000000000000000000000000000000001
100000000001000000000000000000000000000000000000000000000000000100000000000000000000000000000000000000000000000000000000000001
100000000000000000000000000000000000000000000000000000000000000000000000000000000000000000000000000000000001000000000000000001
100000000000000000000000000000000000000000000000000000000000000000000000000000000010000000000000000000000000000000000000000001
100000000000000000000000000000000000000000000000000000000000000000000000000000000000000000000000000000000000000000000000000001
100000000000100000000000000000000000000000000000001000000000000000000000000000000000000000000000000000001110001000000000000001
100000000000000000000000000000000000000000000000000000000000000000000000000000000000010000000000000000010000000000000000000001
100000000000000000000000010000000000000000000000000000000000000000000000000000000000000000000000000000000000000000100000000001
100000000000000000000000000000000000000000000000000000000000000000000000000100000000000000000000000000000000000000000000000001
100000000000000000000000000000000000000000000000000000000000000000000000000000000000000000000000000000000000000000000000000001
100000000000000000000000000000000000000000000000000000000000000000000000000000000000000000000000000000000000000000000000000001
111111111111111111111111111111111111111111111111111111111111111111111111111111111111111111111111111111111111111111111111111111