R 1300 600

NO ./textures/north.xpm   
SO ./textures/south.xpm
WE ./textures/west.xpm
EA ./textures/east.xpm

S ./textures/pikapika.xpm

F 120,100,0
C 1,1,1

1111111111
1000000001
1000200001
1000000001
1000N00001
1000000001
1000000001
1000000001
1111111111
