NO ./textures/north.xpm   
SO ./textures/south.xpm
WE ./textures/west.xpm
EA ./textures/east.xpm

F 120,100,0
C 1,1,1

1111111111
1000000001
1000000001
1000000001
100000E001
1000000001
1000000001
1000000001
1111111111