NO ./textures/white_grunge.xpm
SO ./textures/greystone.xpm
WE ./textures/brick.xpm
EA ./textures/red.xpm

F 64,38,133
C 120,100,255

1111111111
1000000001
100S001001
1000000101
100001N101
1000001101
1000000001
10000000011111111111111
11101010110001011011001
11111111111111111111111