R 1920 1080

NO ./textures/north.xpm   
SO ./textures/south.xpm
WE ./textures/west.xpm
EA ./textures/east.xpm

S ./textures/tonneau.xpm

F 120,100,0
C 1,1,1

11111
10201
10001
10N01
11111
