R 1920 1080

NO ./textures/north.xpm   
SO ./textures/south.xpm
WE ./textures/west.xpm
EA ./textures/east.xpm

S ./textures/pikapika.xpm

F 120,100,0
C 1,1,1

1111111111
1011111001
1011011001
1011011001
1011S11001
1011011001
10110110011111
10110110010001
11111111111111
